B:2,T:1,D:4
MMMMMMMMMMMMMMMMMMMMM
M                   M
M    AAAAAAA        M
M                   M
M     T             M
M           M   DD  M
M           M   DD  M
M   M       M       M
M           MMMMMMMMM
M  BB               M
M                   M
MMMMMMMMMMMMMMMMMMMMM
